學號,姓名,國文,英文,數學,地理,歷史,總分,平均
1,盧文啟,85,77,63,51,88,364,72.8
2,郭舜昇,99,94,83,61,97,434,86.8
3,李淑芳,59,75,99,70,78,381,76.2
4,童建霖,98,94,88,63,78,421,84.2
5,陳姵彬,72,74,50,51,60,307,61.4
6,游倫城,86,69,57,78,66,356,71.2
7,馮芳如,72,51,54,94,79,350,70.0
8,陳冠霞,73,84,60,62,64,343,68.6
9,游治旺,57,87,71,86,94,395,79.0
10,黃佩芬,50,99,56,99,90,394,78.8
